de: day
la: lot
que: case
el: elements
en: analysis
y (NONE)
a (NONE)
los: loss
no: northern
se: say
un: university
por: portrait
del: delta
es: experience
las: last
con (NONE)
una (NONE)
para: part, rock
lo: law
su: son
al: altar
00 (NONE)
como: call, morning
me: making
más: mosque
si: city
pero: paris, roar
o (NONE)
0000: ceremony, australian, aerospace, ceremony, australian, aerospace
te: take
mi: minutes
sus: suspect
este: experience, take
esta: experience, top
le: let
ha (NONE)
todo: talk, daughter
ya (NONE)
ser: saturday
yo (NONE)
cuando: cooler, honor, daughter
son: sauna
sin: cinema
sobre: source, breath
hay: idea
está: experience, top
también: thomson, business, analysis
todos: talk, dawson
fue (NONE)
muy: moisture
tu: touch
000 (NONE)
nos: nausea
puede (NONE)
tiene: tnt, name
entre: analysis, treasury
porque: portrait, case
eso (NONE)
desde: desk, day
qué: can
así: acid
años (NONE)
bien: business, analysis
dos: dawson
esto: experience, talk
hasta: oxygen, top
hacer: oxygen, arrest
ahora (NONE)
vez: best
parte: part, take
era: arrival
hace: assets
ni: nickname
han: honor
nada: novel, dog
tiempo: till, employment, porch
donde: dawn, day
uno (NONE)
vida: business, dog
solo: song, law
algo (NONE)
e (NONE)
mismo: minutes, small
mundo: money, daughter
día (NONE)
están: experience, tonic
tan: tonic
cada: car, dog
estado: experience, top, daughter
mejor: making, hormone
mucho: money, chalk
otros (NONE)
ver: barrier
ese: essay
después: day, species, west
gente: hands, take
siempre: city, employment, president
mas: mosque
personas: paris, song, nasser
sólo: source, law
esa (NONE)
les: lesson
tengo: tank, gong
cosas: call, sos
estoy: experience, toilet
otra: autonomy, rock
otro: autonomy, wrong
va: body
1 (NONE)
ellos: april, australian
gran: great, honor
menos: making, nausea
tanto: tonic, talk
trabajo: trot, body, hall
antes: honor, test
durante: dublin, rendezvous, take
hecho: eight, shaw
sea (NONE)
sido: city, daughter
2: dawson
año (NONE)
he (NONE)
forma: four, market
gracias: great, acid, oxygen
había (NONE)
lugar (NONE)
nunca: none, car
todas: talk, dossier
aquí: okinawa
contra (NONE)
decir: day, series
tener: take, narrator
él: album
estas: experience, toss
estos: estimate, australian
gobierno: gong, business, arrest, northern
poco: porch, call
nuevo (NONE)
aunque: ounce, case
creo (NONE)
cómo: course, morning
país: part, estate
3: training, experience
dios: development, australian
quiero: king, aurora
sí: city
cuenta: cooler, analysis, top
soy: soil
tienen: tnt, nan
dice: development, say
ella: april, yard
estar: experience, target
nuestro: news, experience, trauma
quien: king, analysis
toda: talk, dog
casa: car, soccer
muchos: money, child, australian
caso: car, song
hoy: oil
momento: morning, man, talk
nuestra: news, experience, trot
otras: autonomy, raspberry
pueden: pool, aid, analysis
tres: training, experience
alguien (NONE)
ciudad: city, eugene, odds
debe: day, baby
luego (NONE)
poder: porch, dairy
verdad: barrier, dada
voy: boy
algunos (NONE)
cual: cooler, altar
días: development, oxygen
entonces (NONE)
historia: estate, torah, reality
nacional (NONE)
nueva (NONE)
pues: pool, experience
estaba: experience, top, body
mayor: market, yoruba
mis: miss
nadie: nod, yesterday
parece: part, assembly
sino: city, northern
tal: tolerance
acuerdo: october, wear, daughter
bueno (NONE)
mientras: minutes, anti, raspberry
veces: baby, sesame
además: odds, employment, oxygen
general: health, national, raleigh
nosotros: northern, source, training, australian
tipo: till, porch
manera: monster, arrival
primera: problem, emergency, arrival
hombre (NONE)
ir: iran
sistema: city, story, emile
5: cinema, call
bajo: body, hall
cualquier: cooler, altar, king, arrest
fueron (NONE)
hacia: oxygen, yard
muchas: money, child, oxygen
nombre (NONE)
partido: part, till, daughter
según (NONE)
4: quality, trauma
dijo: development, hall
primer: prison, marriage
eres: arrest, accident
fuera: voodoo, arrival
grupo: grudge, porch
ley: lady
medio: making, diocese
política: porch, leech, economy
haber: observation, arrest
tenemos: take, name, moss
mal: mali
persona: paris, song, novel
será: saturday, rock
unos: university, australian
da: dog
pueblo: pool, abel, law
dentro: dancing, trauma
estamos: experience, top, moss
fin: vintage
españa (NONE)
estados: experience, top, dawson
información (NONE)
puedo (NONE)
quiere: king, arabic
aún (NONE)
casi: car, city
embargo (NONE)
guerra: gas, rock
lado: lot, daughter
ti: till
buena: booth, enactment
dinero: dinner, aurora
mujer: money, harrison
méxico: matter, history, call
problema: program, blood, emile
cosa: call, soccer
ejemplo (NONE)
importante: emergency, portrait, tonic, take
misma: minutes, smart
pasado: part, soccer, daughter
podemos: porch, day, moss
